2 2 2 2 2 2 2 2 2 2 2 2 2 2 2 2 2 2 2 2 2 2 2 2 2 2 2 2 2 2 2 2 2 2 2 2 2 2 2 2 2 2 2 2 2 2 2 2 2 2 2 2 2 2 2 2 2 2 2 2 2 2 2 2 11 2 2 2 2 2 2 2 2 2 2 2 2 2 2 2 2 2 2 2 2 2 2 2 2 2 2 2 2 2 2 2 2 2 2 2 2 2 11 2 2 2 2 2 2 2 2 2 2 2 2 2 2 2 2 2 2 2 2 2 2 2 2 2 2 2 2 2 2 2 2 2 2 2 2 2 2 2 2 2 2 2 2 2 2 2 2 2 2 2 2 2 2 2 2 2 2 2 2 2 2 2 2 2 2 2 2 2 2 2 2 2 2 2 2 2 2 2 2 2 2 11 2 2 2 2 2 2 2 2 2 2 2 2 2 2 
87 2 2 2 2 2 2 2 2 2 2 2 2 2 2 2 2 2 2 2 2 2 2 2 2 2 2 2 2 2 2 2 2 2 2 2 2 2 2 2 2 2 2 2 2 2 2 2 2 2 2 2 2 2 2 2 2 2 2 2 2 2 2 2 11 2 2 2 2 2 2 2 2 2 2 2 2 2 2 2 2 2 2 2 2 2 2 2 2 2 2 2 2 2 2 2 2 2 2 2 2 2 11 2 2 2 2 2 2 2 2 2 2 2 2 2 2 2 2 2 2 2 2 2 2 2 2 2 2 2 2 2 2 2 2 2 2 2 2 2 2 2 2 2 2 2 2 2 2 2 2 2 2 2 2 2 2 2 2 2 2 2 2 2 2 2 2 2 2 2 2 2 2 2 2 2 2 2 2 2 2 2 2 2 2 11 2 2 2 2 2 2 2 2 2 2 2 2 2 2 
90 2 2 2 2 2 2 2 2 2 2 2 2 2 2 2 2 2 2 2 2 2 2 2 2 2 2 2 2 2 2 2 2 2 2 2 2 2 2 2 2 2 2 2 2 2 2 2 2 2 2 2 2 2 2 2 2 2 2 2 2 2 2 2 11 2 2 2 2 2 2 2 2 2 2 2 2 2 2 2 2 2 2 2 2 2 2 2 2 2 2 2 2 2 2 2 2 2 2 2 2 2 11 2 2 2 2 2 2 2 2 2 2 2 2 2 2 2 2 2 2 2 2 2 2 2 2 2 2 2 2 2 2 2 2 2 2 2 2 2 31 32 33 2 2 2 2 2 2 2 2 2 2 2 2 2 2 2 2 2 2 2 2 2 2 2 2 2 2 2 2 2 2 2 2 2 2 2 2 2 2 2 2 2 2 11 2 2 2 2 2 2 2 2 2 2 2 2 2 78 
90 2 2 2 2 2 2 2 2 2 2 2 2 2 2 2 2 2 2 2 2 2 2 2 2 2 2 2 2 2 2 2 2 2 2 2 2 2 2 2 2 2 2 2 2 2 2 2 2 2 2 2 2 2 2 2 2 2 2 2 2 2 2 2 11 2 2 2 2 2 2 2 2 2 2 2 2 2 2 2 2 2 2 2 2 2 2 2 2 2 2 2 2 2 2 2 2 2 2 2 2 2 11 2 2 2 2 2 2 2 2 2 2 2 2 2 2 2 2 2 2 2 2 2 2 2 2 2 2 2 2 2 2 2 2 2 2 2 2 2 41 42 43 2 2 2 2 2 2 2 2 2 2 2 2 2 2 2 2 2 2 2 2 2 2 2 2 2 2 2 2 2 2 2 2 2 2 2 2 2 2 2 2 2 2 11 2 2 2 2 2 2 2 2 2 2 2 2 2 88 
90 2 2 2 2 2 2 2 2 2 2 2 2 2 2 2 2 2 2 2 2 2 2 2 2 2 2 2 2 2 2 2 2 2 2 2 2 2 2 2 2 2 2 2 2 2 2 2 2 2 2 2 2 2 2 2 2 2 2 2 2 2 2 2 11 2 2 2 2 2 2 2 2 2 2 2 2 2 2 2 2 2 2 2 2 2 2 2 2 2 2 2 2 2 2 2 2 2 2 2 2 2 11 2 2 2 2 2 2 2 2 2 2 2 2 2 2 2 2 2 2 2 2 2 2 2 2 2 2 2 2 2 2 2 2 2 2 2 2 2 51 52 53 2 2 2 2 2 2 2 2 2 2 2 2 2 2 2 2 2 2 2 2 2 2 2 2 2 2 2 2 2 2 2 2 2 2 2 2 2 2 2 2 2 2 11 2 2 2 2 2 2 2 2 2 2 2 2 2 88 
90 2 2 2 2 2 2 2 2 2 2 2 2 2 2 2 2 2 2 2 2 2 2 2 2 2 2 2 2 2 2 2 2 2 2 2 2 2 2 2 2 3 2 2 5 2 2 2 2 2 2 2 2 2 2 2 2 2 2 2 2 2 2 2 11 2 2 2 2 2 2 2 2 2 2 2 2 2 2 2 2 2 2 2 2 2 2 2 2 2 2 2 2 2 2 2 2 2 2 2 2 2 11 2 2 2 2 2 2 2 2 2 2 2 2 2 2 2 2 2 2 2 2 2 2 2 2 2 2 2 2 2 2 2 2 2 2 2 2 2 85 86 87 2 2 2 2 2 2 2 2 2 2 2 2 2 2 2 2 2 2 2 2 2 2 2 2 2 2 2 2 2 2 2 2 2 2 2 2 2 2 2 2 2 2 11 2 2 2 2 2 2 2 2 2 2 2 2 2 88 
90 2 2 2 2 2 2 2 2 2 2 2 2 2 2 2 2 2 5 2 2 2 2 2 2 2 2 2 2 2 2 2 2 2 2 2 2 2 2 78 78 78 78 78 78 79 80 2 2 2 2 2 2 2 2 2 2 2 2 2 2 2 2 2 11 2 2 2 2 2 2 2 2 2 2 2 2 2 2 2 2 2 2 2 2 2 2 2 3 5 2 2 2 2 2 2 2 2 2 2 2 2 11 2 2 2 2 2 2 2 2 2 2 2 2 2 2 2 2 2 2 2 2 2 2 2 2 2 2 2 2 2 2 2 2 2 2 2 2 2 2 2 2 2 2 2 2 2 2 2 2 2 2 2 2 2 2 2 2 2 2 2 2 2 2 2 2 2 2 2 2 2 2 2 2 2 2 2 2 2 2 2 2 2 2 11 2 2 2 2 2 2 2 2 2 2 2 2 2 88 
90 2 2 2 2 2 2 2 2 2 2 2 2 2 2 2 78 79 80 2 2 2 2 2 2 2 2 2 2 2 2 2 2 2 2 2 2 2 2 88 89 89 89 89 89 89 90 2 2 2 2 2 2 2 2 2 2 2 2 2 2 2 2 2 11 2 2 2 2 2 2 2 2 2 2 2 2 2 2 2 2 31 32 33 2 2 2 78 79 79 79 80 2 2 2 2 2 2 2 2 2 2 11 2 2 2 2 2 2 2 2 2 2 2 2 2 2 2 2 2 2 6 2 2 2 2 2 2 2 2 2 2 2 2 2 2 2 85 86 87 2 2 2 2 2 2 2 2 2 2 2 2 2 2 2 2 2 2 2 2 2 2 2 2 2 2 2 2 2 2 2 2 2 2 2 2 2 2 2 2 2 2 2 2 2 11 2 2 2 2 2 2 2 2 2 2 2 2 2 88 
90 2 2 2 2 2 2 2 2 2 2 2 2 2 2 3 88 89 90 6 2 2 2 2 2 2 2 2 2 2 2 2 2 5 2 3 2 2 2 88 89 81 82 83 89 89 90 2 2 2 2 2 2 2 2 2 2 2 2 2 2 2 2 2 11 2 2 2 2 2 2 2 2 2 2 2 2 2 2 2 2 41 42 43 2 2 2 88 89 89 89 90 2 2 2 2 2 2 2 2 2 2 11 2 2 2 2 2 2 2 2 2 2 2 2 2 2 2 2 2 85 86 87 2 2 2 2 2 2 2 2 2 2 2 2 3 2 2 2 2 2 2 2 2 2 2 2 2 2 2 2 2 2 2 2 2 2 2 2 2 2 2 2 2 2 2 2 2 2 2 2 2 2 2 2 2 2 2 2 2 2 2 2 2 2 11 2 2 2 2 2 2 2 2 2 31 32 33 2 88 
90 2 2 2 2 2 2 2 2 2 2 2 2 2 78 78 78 78 79 79 80 2 2 2 2 2 2 2 2 2 2 78 78 78 78 79 80 2 2 88 89 91 92 93 94 89 90 2 2 2 2 2 2 2 2 2 2 2 2 2 2 2 2 2 11 2 2 2 2 2 2 2 2 2 2 5 2 2 2 3 2 51 52 53 2 2 2 88 89 89 89 90 2 2 2 2 2 2 2 2 2 2 11 2 2 2 2 2 2 2 2 2 2 2 2 2 2 2 2 2 2 2 2 2 2 2 2 2 2 2 2 2 2 2 85 86 87 2 2 2 2 2 2 2 2 2 2 2 2 2 2 2 2 2 2 2 2 2 2 2 2 2 2 2 2 2 2 2 2 2 2 2 2 2 2 2 2 2 2 2 2 2 2 2 2 11 2 2 2 2 2 2 2 2 2 41 42 43 2 88 
90 2 2 2 2 2 2 2 2 2 2 2 2 2 88 89 89 89 89 89 90 2 2 2 2 2 2 2 2 2 2 88 89 89 89 89 90 2 2 88 89 89 89 89 89 89 90 2 2 2 2 2 2 2 2 2 2 2 2 2 2 2 2 2 11 2 2 2 2 2 2 2 2 2 78 79 79 79 79 79 79 79 79 80 2 2 2 88 89 89 89 90 2 2 2 2 2 2 2 2 2 2 11 2 2 2 2 2 2 2 2 2 2 2 85 86 87 2 2 2 2 2 2 2 2 2 2 2 2 2 2 2 3 2 2 2 2 2 2 2 2 2 2 2 2 2 2 2 2 2 2 2 2 2 2 2 2 2 2 2 2 2 2 2 2 2 2 2 2 2 2 2 2 2 2 2 2 2 2 2 2 2 2 2 2 21 2 2 2 2 2 6 2 95 2 51 52 53 2 88 
90 2 2 3 4 2 5 2 2 6 2 2 2 2 88 89 89 89 89 89 90 2 2 2 2 2 3 2 6 2 2 88 89 89 89 89 90 2 2 88 89 89 89 89 89 89 90 2 2 2 2 2 2 5 2 2 2 6 2 2 2 2 2 2 21 2 2 5 2 2 2 2 2 2 88 89 89 76 89 89 89 89 89 90 2 2 2 88 89 89 89 90 2 2 2 2 5 2 3 2 2 2 17 2 2 6 2 2 2 2 2 2 2 2 2 2 2 2 2 2 2 2 2 2 2 2 2 2 2 2 2 85 86 87 2 2 2 2 2 2 2 2 2 2 2 2 2 2 2 2 3 2 2 2 2 3 6 2 2 2 2 2 2 6 14 2 2 2 2 2 2 2 6 2 2 2 2 2 3 2 2 2 2 2 78 79 79 79 79 79 79 79 79 79 79 79 79 80 2 88 
90 2 2 78 79 79 79 79 79 80 2 2 2 2 88 81 82 83 89 89 90 2 2 2 2 78 79 80 80 2 2 88 89 89 89 89 90 2 2 88 89 89 89 89 89 89 90 2 2 2 2 2 78 79 79 79 79 80 2 2 2 2 2 78 79 79 79 79 79 79 80 2 2 2 88 81 82 83 89 89 89 89 89 90 2 2 2 88 89 89 89 90 2 2 78 79 79 79 79 79 79 79 79 79 79 79 79 79 79 80 2 2 2 2 2 2 2 2 2 2 2 2 2 2 2 85 86 87 2 2 2 2 2 2 2 2 2 2 2 2 2 2 2 2 2 2 2 2 78 79 80 2 2 2 2 78 79 80 2 2 2 2 78 79 80 2 2 2 2 2 78 79 79 79 79 79 79 79 79 79 80 2 2 2 88 89 89 89 89 89 89 81 82 83 89 89 89 90 2 88 
90 2 2 88 89 89 89 89 89 90 2 2 2 2 88 91 92 93 94 89 90 2 2 2 2 88 89 89 90 2 2 88 89 89 89 89 90 2 2 88 89 89 89 89 89 89 90 2 2 2 2 2 88 89 89 89 89 90 2 2 2 2 2 88 89 89 89 89 89 89 90 2 2 2 88 91 92 93 94 89 89 89 89 90 2 2 2 88 89 89 89 90 2 2 88 89 89 89 89 89 89 89 89 89 89 89 89 89 89 90 2 2 2 2 2 2 2 2 2 2 2 2 2 2 2 2 2 2 2 2 2 2 2 2 2 2 2 2 2 2 2 2 2 2 2 2 2 2 88 89 90 2 2 2 2 88 89 90 2 2 2 2 88 89 90 2 2 2 2 2 88 89 89 89 89 89 89 89 89 89 90 2 2 2 88 89 89 89 89 89 89 91 92 93 94 89 89 90 2 88 
100 19 20 98 99 99 99 99 99 100 19 20 18 19 98 89 89 89 89 89 100 18 19 20 18 98 99 99 100 20 18 98 89 89 89 89 100 19 20 98 89 89 89 89 89 89 100 20 18 19 20 18 98 89 89 89 89 100 19 20 18 19 20 98 89 89 89 89 89 89 100 18 19 20 98 99 99 99 99 99 99 99 99 100 19 20 18 98 99 99 99 100 18 19 98 89 89 89 89 89 89 89 89 89 89 89 89 89 89 100 18 19 20 18 19 20 18 19 20 18 19 20 18 19 20 18 19 20 18 19 20 18 19 20 18 19 20 18 19 20 18 19 20 18 19 20 18 19 98 99 100 20 18 19 20 98 99 100 18 19 20 18 98 99 100 19 20 18 19 20 98 99 99 99 99 99 99 99 99 99 100 20 18 19 98 99 99 99 99 99 99 99 99 99 99 99 99 100 19 98

