3 2 2 2 2 2 2 2 2 2 2 2 2 2 2 2 2 2 2 2 2 2 2 2 2 2 2 2 2 2 2 2 2 2 2 2 2 2 2 2 2 2 2 2 2 2 2 2 2 2 2 2 2 2 2 2 2 2 2 2 2 2 2 2 11 2 2 2 2 2 2 2 2 2 2 2 2 2 2 2 2 2 2 2 2 2 2 2 2 2 2 2 2 2 2 2 2 2 2 2 2 2 11 2 2 2 2 2 2 2 2 2 2 2 2 2 2 2 2 2 2 2 2 2 2 2 2 2 2 2 2 2 2 2 2 2 2 2 2 2 2 2 2 2 2 2 2 2 2 2 2 2 2 2 2 2 2 2 2 2 2 2 2 2 2 2 2 2 2 2 2 2 2 2 2 2 2 2 2 2 2 2 2 2 11 2 2 2 2 2 2 2 2 2 2 2 2 2 2 2 
80 16 2 2 2 2 2 2 2 2 2 2 2 2 2 2 2 2 2 2 2 2 2 2 2 2 2 2 2 2 2 2 2 2 2 2 2 2 2 2 2 2 2 2 2 2 2 2 2 2 2 2 2 2 2 2 2 2 2 2 2 2 2 2 11 2 2 2 2 2 2 2 2 2 2 2 2 2 2 2 2 2 2 2 2 2 2 2 2 2 2 2 2 2 2 2 2 2 2 2 2 2 11 2 2 2 2 2 2 2 2 2 2 2 2 2 2 2 2 2 2 2 2 2 2 2 2 2 2 2 2 2 2 2 2 2 2 2 2 2 2 2 2 2 2 2 2 2 2 2 2 2 2 2 2 2 2 2 2 2 2 2 2 2 2 2 2 2 2 2 2 2 2 2 2 2 2 2 2 2 2 2 2 2 11 2 2 2 2 2 2 2 2 2 2 2 2 2 3 2 
90 2 2 2 2 2 2 2 2 2 2 2 2 2 2 2 2 2 2 2 2 2 2 2 2 2 2 2 2 2 2 2 2 2 2 2 2 2 2 2 2 2 2 2 2 2 2 2 2 2 2 2 2 2 2 2 2 2 2 2 2 2 2 2 11 2 2 2 2 2 2 2 2 2 2 2 2 2 2 2 2 2 2 2 2 2 2 2 2 2 2 2 2 2 2 2 2 2 2 2 2 2 11 2 2 2 2 2 2 2 2 2 2 2 2 2 2 2 2 2 2 2 2 2 2 2 2 2 2 2 2 2 2 2 2 2 2 2 2 2 31 32 33 2 2 2 2 2 2 2 2 2 2 2 2 2 2 2 2 2 2 2 2 2 2 2 2 2 2 2 2 2 2 2 2 2 2 2 2 2 2 2 2 2 11 2 2 2 2 2 2 2 2 2 2 2 2 12 78 78 
90 2 2 2 2 2 2 2 2 2 2 2 2 2 2 2 2 2 2 2 2 2 2 2 2 2 2 2 2 2 2 2 2 2 2 2 2 2 2 2 2 2 2 2 2 2 2 2 2 2 2 2 2 2 2 2 2 2 2 2 2 2 2 2 11 2 2 2 2 2 2 2 2 2 2 2 2 2 2 2 2 2 2 2 2 2 2 2 2 2 2 2 2 2 2 2 2 2 2 2 2 2 11 2 2 2 2 2 2 2 2 2 2 2 2 2 2 2 2 2 2 2 2 2 2 2 2 2 2 2 2 2 2 2 2 2 2 2 2 2 41 42 43 2 2 2 2 2 2 2 2 2 2 2 2 2 2 2 2 2 2 2 2 2 2 2 2 2 2 2 2 2 2 2 2 2 2 3 4 2 2 2 2 2 11 2 2 2 2 2 2 2 2 2 2 2 2 2 88 88 
90 2 2 2 2 2 2 2 2 2 2 2 2 2 2 2 4 4 5 2 2 2 2 2 2 2 2 2 2 2 2 2 2 2 2 2 2 2 2 2 2 2 2 2 2 2 2 2 2 2 2 2 2 2 2 2 2 2 2 2 2 2 2 2 11 2 2 2 2 2 2 2 2 2 2 2 2 2 2 2 2 2 2 2 2 2 2 2 2 2 2 2 2 2 2 2 2 2 2 2 2 2 11 2 2 2 2 2 2 2 2 2 2 2 2 2 2 2 2 2 2 2 2 2 2 2 2 2 2 2 2 2 2 2 2 2 2 2 2 2 4 52 4 2 2 2 2 2 2 2 2 2 2 2 2 2 2 2 2 2 2 2 2 2 2 2 2 2 2 2 2 2 2 2 2 2 12 78 80 16 2 2 2 2 11 2 2 2 2 2 2 2 2 2 2 2 2 2 88 88 
90 2 2 2 2 2 2 2 2 2 2 2 2 2 2 12 85 86 87 16 2 2 2 2 2 2 2 2 2 2 2 2 2 2 2 2 2 2 2 2 4 3 4 4 5 4 4 2 2 2 2 2 2 2 2 2 2 2 2 2 2 2 2 2 11 2 2 2 2 2 2 2 2 2 2 2 2 2 2 2 2 2 2 2 2 2 2 2 2 2 2 2 2 2 2 2 2 2 2 2 2 2 11 2 2 2 2 2 2 2 2 2 2 2 2 2 2 2 2 2 2 2 2 2 2 2 2 2 2 2 2 2 2 2 2 2 2 2 2 12 85 86 87 16 2 2 2 2 2 2 2 2 2 2 2 2 2 2 2 2 2 2 2 2 2 2 2 2 2 2 2 2 2 2 2 4 4 88 90 2 2 2 2 2 11 2 2 2 2 2 2 2 2 2 2 2 2 2 88 88 
90 2 2 2 2 2 2 2 2 2 2 2 2 2 2 2 15 23 25 2 2 2 2 2 2 2 2 2 2 2 2 2 2 2 2 2 2 2 2 2 78 78 78 78 78 79 80 16 2 2 2 2 2 2 2 2 2 2 2 2 2 2 2 2 11 2 2 2 2 2 2 2 2 2 2 2 2 2 2 2 2 2 2 2 2 2 2 4 3 5 4 4 2 2 2 2 2 2 2 2 2 2 11 2 2 2 2 2 2 2 2 2 2 2 2 2 2 2 2 2 2 2 2 2 2 2 2 2 2 2 2 2 2 2 2 2 2 4 4 4 15 23 25 2 2 2 2 2 2 2 2 2 2 2 2 2 2 2 2 2 2 2 2 2 2 2 2 2 2 2 2 2 2 2 12 78 79 77 90 2 2 2 2 2 11 2 2 2 2 2 2 2 2 2 2 2 2 2 88 88 
90 2 2 2 2 2 2 2 2 2 2 2 2 2 2 2 2 2 2 2 2 2 2 2 2 2 2 2 2 2 2 2 2 2 2 2 2 2 2 2 88 89 89 89 89 89 90 2 2 2 2 2 2 2 2 2 2 2 2 2 2 2 2 2 11 2 2 2 2 2 2 2 2 2 2 2 2 2 2 2 2 31 32 33 2 2 12 78 79 79 79 80 16 2 2 2 2 2 2 2 2 2 11 2 2 2 2 2 2 2 2 2 2 2 2 2 2 2 2 2 4 6 7 2 2 2 2 2 2 2 2 2 2 2 2 2 12 85 86 87 16 2 2 2 2 2 2 2 2 2 2 2 2 2 2 2 2 2 2 2 2 2 2 2 2 2 2 2 2 2 2 2 2 4 5 88 89 89 90 2 2 2 2 2 11 2 2 2 2 2 2 2 2 2 2 2 2 2 88 88 
90 2 2 2 2 2 2 2 2 2 2 2 2 2 4 3 4 4 4 6 7 2 2 2 2 2 2 2 2 2 2 4 4 5 4 3 4 2 2 2 88 81 82 83 89 89 90 2 2 2 2 2 2 2 2 2 2 2 2 2 2 2 2 2 11 2 2 2 2 2 2 2 2 2 2 2 2 2 2 2 2 41 42 43 2 2 2 88 89 89 89 90 2 2 2 2 2 2 2 2 2 2 11 2 2 2 2 2 2 2 2 2 2 2 2 2 2 2 2 12 85 86 87 16 2 2 2 2 2 2 2 2 2 2 4 3 4 15 23 25 2 2 2 2 2 2 2 2 2 2 2 2 2 2 2 2 2 2 2 2 2 2 2 2 2 2 2 2 2 2 2 2 2 78 79 77 89 89 90 2 2 2 2 2 11 2 2 2 2 2 2 2 2 2 31 32 33 2 88 88 
90 2 2 2 2 2 2 2 2 2 2 2 2 12 78 79 79 79 79 79 80 16 2 2 2 2 2 2 2 2 12 78 79 79 79 79 80 16 2 2 88 91 92 93 94 89 90 2 2 2 2 2 2 2 2 2 2 2 2 2 2 2 2 2 11 2 2 2 2 2 2 2 2 2 4 5 4 4 4 3 4 4 52 4 2 2 2 88 89 89 89 90 2 2 2 2 2 2 2 2 2 2 11 2 2 2 2 2 2 2 2 2 2 2 4 4 4 2 2 2 15 23 25 2 2 2 2 2 2 2 2 2 2 12 85 86 87 16 2 2 2 2 2 2 2 2 2 2 2 2 2 2 2 2 2 2 2 2 2 2 2 2 2 2 2 2 2 2 2 2 2 4 5 88 89 89 89 89 90 3 2 2 2 2 11 2 2 2 2 2 2 2 2 2 41 42 43 3 88 88 
90 2 2 2 2 2 2 2 2 2 2 2 2 2 88 89 89 89 89 89 90 2 2 2 2 2 2 2 2 2 2 88 89 89 89 89 90 2 2 2 88 89 89 89 89 89 90 2 2 2 2 2 2 2 2 2 2 2 2 2 2 2 2 2 11 2 2 2 2 2 2 2 2 12 78 79 79 79 79 79 79 79 79 80 16 2 2 88 89 89 89 90 2 2 2 2 2 2 2 2 2 2 11 2 2 2 2 2 2 2 2 2 2 12 85 86 87 16 2 2 2 2 2 2 2 4 6 7 2 2 2 4 3 4 15 23 25 2 2 2 2 2 2 2 2 2 2 2 2 2 2 2 2 2 2 2 2 2 2 2 2 2 2 2 2 2 2 2 2 2 12 78 79 77 89 89 89 89 89 80 4 4 4 4 21 4 4 4 4 4 6 7 5 4 3 52 3 78 77 88 
90 2 2 3 4 4 5 4 6 7 2 2 2 2 88 89 89 89 89 89 90 2 2 2 4 3 2 6 2 2 2 88 89 89 89 89 90 2 2 2 88 89 89 89 89 89 90 2 2 2 2 2 4 5 4 4 4 5 2 2 2 2 2 4 21 4 4 5 4 4 4 2 2 2 88 89 89 76 89 89 89 89 89 90 2 2 2 88 89 89 89 90 2 2 2 2 4 4 5 4 4 4 21 4 4 6 7 4 4 4 2 2 2 2 15 23 25 2 2 2 2 2 2 2 12 85 86 87 16 2 12 85 86 87 16 2 2 2 2 2 2 2 2 2 2 2 2 2 4 4 3 2 2 2 2 3 6 7 2 2 2 2 4 6 7 2 2 2 2 4 4 88 89 89 89 89 89 89 89 76 79 79 79 79 79 79 79 79 79 79 79 79 79 79 79 79 79 77 89 88 
76 79 79 79 79 79 79 79 79 80 16 2 2 2 88 81 82 83 89 89 90 2 2 12 78 79 79 80 16 2 2 88 89 89 89 89 90 2 2 2 88 89 89 89 89 89 90 2 2 2 2 12 78 79 79 79 79 80 16 2 2 2 12 78 79 79 79 79 79 79 80 16 2 2 88 81 82 83 89 89 89 89 89 90 2 2 2 88 89 89 89 90 2 2 2 12 78 79 79 79 79 79 79 79 79 79 79 79 79 80 16 2 2 2 2 2 2 2 2 2 2 2 2 2 2 15 23 25 2 2 2 15 23 25 2 2 2 2 2 2 2 2 2 2 2 2 2 12 78 79 80 16 2 2 12 78 79 80 16 2 2 12 78 79 80 16 2 2 12 78 79 77 89 89 89 89 89 89 89 89 89 89 89 89 89 89 89 89 89 89 81 82 83 89 89 89 89 89 89 88 
89 89 89 89 89 89 89 89 89 97 20 20 20 20 96 91 92 93 94 89 97 20 20 20 96 89 89 97 20 20 20 96 89 89 89 89 97 20 20 20 96 89 89 89 89 89 97 20 20 20 20 20 96 89 89 89 89 97 20 20 20 20 20 96 89 89 89 89 89 89 97 20 20 20 96 91 92 93 94 89 89 89 89 97 20 20 20 96 89 89 89 97 20 20 20 20 96 89 89 89 89 89 89 89 89 89 89 89 89 97 20 20 20 20 20 20 20 20 20 20 20 20 20 20 20 20 20 20 20 20 20 20 20 20 20 20 20 20 20 20 20 20 20 20 20 20 20 20 96 89 97 20 20 20 20 96 89 97 20 20 20 20 96 89 97 20 20 20 20 96 89 89 89 89 89 89 89 89 89 89 89 89 89 89 89 89 89 89 89 89 91 92 93 94 89 89 89 89 96 88 
99 99 99 99 99 99 99 99 99 97 30 30 30 30 96 89 89 89 89 89 97 30 30 30 96 99 99 97 30 30 30 96 89 89 89 89 97 30 30 30 96 89 89 89 89 89 97 30 30 30 30 30 96 89 89 89 89 97 30 30 30 30 30 96 89 89 89 89 89 89 97 30 30 30 96 99 99 99 99 99 99 99 99 97 30 30 30 96 99 99 99 97 30 30 30 30 96 89 89 89 89 89 89 89 89 89 89 89 89 97 30 30 30 30 30 30 30 30 30 30 30 30 30 30 30 30 30 30 30 30 30 30 30 30 30 30 30 30 30 30 30 30 30 30 30 30 30 30 96 99 97 30 30 30 30 96 99 97 30 30 30 30 96 99 97 30 30 30 30 96 99 99 99 99 99 99 99 99 99 99 99 99 99 99 99 99 99 99 99 99 99 99 99 99 99 99 99 99 99 98

