17 8 9 8 9 8 9 8 9 8 9 8 9 8 9 8 9 8 9 8 9 18 0 0 17 8 9 8 9 8 9 8 9 8 9 8 9 8 9 8 9 8 9 8 9 18 0 0 0 0 
16 0 0 0 0 0 0 0 0 0 0 0 0 0 0 0 0 0 0 0 0 15 0 0 16 0 0 0 0 0 0 0 0 0 0 0 0 0 0 0 0 0 0 0 0 15 0 0 0 0 
23 0 0 0 0 0 0 0 0 0 0 0 0 0 0 0 0 0 0 0 0 22 0 0 23 0 0 0 0 0 0 0 0 0 0 0 0 0 0 0 0 0 0 0 0 22 0 0 0 0 
16 0 0 0 0 0 0 0 0 0 0 0 0 0 0 0 0 0 0 0 0 10 8 9 11 0 0 0 0 0 0 0 0 0 0 0 0 0 0 0 0 0 0 0 0 15 0 0 0 0 
23 0 0 0 0 0 0 0 0 0 0 0 0 0 0 0 0 0 0 0 0 0 0 0 0 0 0 0 0 0 0 0 0 0 0 0 0 3 1 1 1 4 0 0 0 22 0 0 0 0 
16 0 0 0 0 0 0 0 0 0 0 0 3 1 1 1 1 1 4 0 0 0 0 0 0 0 0 3 1 4 0 0 3 1 4 0 0 22 17 8 8 11 0 0 0 15 0 0 0 0 
23 0 0 0 0 0 0 0 0 0 0 0 10 8 8 8 8 8 11 0 0 0 0 0 0 0 0 10 8 11 0 0 10 8 11 0 0 10 11 0 0 0 0 0 0 10 8 9 8 18 
16 0 0 0 0 0 0 3 4 0 0 0 0 0 0 0 0 0 0 0 0 0 0 0 3 1 4 0 0 0 0 0 0 0 0 0 0 0 0 0 0 0 0 0 0 0 0 0 15 15 
23 0 0 0 0 0 3 25 24 4 0 0 0 0 0 0 0 0 0 0 0 0 0 3 25 32 16 0 0 0 0 0 0 0 0 0 0 0 0 0 0 0 0 0 0 0 0 0 22 22 
24 1 2 1 2 1 25 32 32 24 2 1 2 1 2 1 2 1 2 1 2 1 2 25 32 32 24 1 2 1 2 1 2 1 2 1 2 1 2 1 2 1 2 1 2 1 2 1 22 25

