35 26 37 38 39 6 7 8 9 10 10 2 3 4 5 6 7 8 9 10 2 3 4 5 6 7 8 9 10 2 3 4 5 6 7 8 9 10 2 3 4 5 6 7 8 9 10 2 3 4 5 6 7 8 9 10 2 3 4 5 6 7 8 9 10 2 3 4 5 6 7 8 9 10 2 3 4 5 6 7 8 9 10 2 3 4 5 6 7 8 9 10 2 3 4 5 6 7 8 9 10 2 3 4 5 6 7 8 9 10 2 3 4 5 6 7 8 9 10 2 3 4 5 6 7 8 9 10 2 3 4 5 6 7 8 9 10 2 3 4 5 6 7 8 9 10 2 3 4 5 6 7 8 9 10 2 3 4 5 6 7 8 9 10 2 3 4 5 6 7 8 9 10 2 3 4 5 6 7 8 9 10 2 3 4 5 6 7 8 9 10 2 3 4 5 6 7 8 1 1 
11 12 29 30 29 30 29 30 29 30 29 30 29 22 29 30 29 30 29 30 29 30 29 30 29 30 29 30 29 30 29 30 29 30 29 30 29 30 29 30 29 30 29 30 29 22 29 30 29 30 29 30 29 30 29 30 29 30 29 30 22 30 29 30 29 30 29 30 29 30 29 30 29 30 29 30 29 30 29 30 29 30 29 30 29 30 29 30 29 30 29 30 12 30 29 30 29 30 29 30 29 30 29 30 29 30 29 30 29 30 29 30 29 30 29 30 29 30 29 30 29 30 29 30 29 30 29 30 29 30 22 30 29 30 29 30 29 30 29 30 29 30 29 30 29 30 29 30 29 30 29 30 29 30 29 30 29 30 29 30 29 30 29 30 29 30 29 30 29 30 29 30 12 30 29 30 29 30 29 30 29 30 29 30 29 30 29 30 29 30 29 30 12 30 29 30 29 30 11 11 
21 22 19 20 19 20 19 20 19 20 19 20 19 12 19 20 19 20 19 20 19 20 19 20 19 20 19 20 19 20 19 20 19 20 19 20 19 20 19 20 19 20 19 20 19 12 19 20 19 20 19 20 19 20 19 20 19 66 19 20 12 20 19 20 19 20 19 20 19 20 19 20 19 20 19 20 19 20 30 29 30 29 30 29 19 30 29 30 29 30 29 20 22 20 19 20 19 20 19 20 19 20 19 20 19 20 19 20 19 20 19 20 19 20 19 20 19 20 19 20 19 20 19 20 19 20 19 20 19 20 12 20 19 20 19 20 19 20 19 20 19 20 19 20 19 20 19 20 19 20 19 20 19 20 19 20 19 20 19 20 19 20 19 20 19 20 19 20 19 20 19 20 22 20 19 20 19 20 19 20 19 20 19 20 19 20 19 20 19 20 19 20 22 20 19 20 19 20 21 21 
31 12 29 30 29 30 29 30 29 30 29 30 29 22 29 30 29 30 29 30 29 30 29 30 29 30 29 30 29 30 29 30 29 30 29 30 29 30 29 30 29 30 29 30 29 22 29 66 29 30 29 30 29 30 29 30 29 30 29 30 22 30 29 30 29 30 29 30 29 30 29 30 29 30 29 30 29 30 20 19 20 19 20 19 29 20 19 20 19 20 19 30 12 30 29 30 29 30 29 30 29 30 29 30 66 66 29 30 29 30 29 30 30 29 30 29 30 29 29 30 29 30 66 30 29 30 29 30 29 30 22 30 29 30 29 30 29 30 29 30 29 30 29 30 29 30 29 30 29 30 29 30 29 30 29 30 29 30 29 30 29 30 29 30 29 30 29 30 29 30 29 30 12 30 29 30 29 30 29 30 29 30 29 30 29 30 29 30 29 30 29 30 12 30 29 30 29 30 31 31 
41 22 19 20 19 20 19 20 19 20 19 20 19 12 19 20 19 20 19 20 19 20 19 20 19 20 19 20 19 20 19 20 19 20 19 20 19 20 19 20 19 20 19 20 19 12 19 20 19 20 19 20 19 20 19 20 19 20 19 20 12 20 19 66 19 20 19 20 19 20 19 30 29 30 29 30 29 30 30 29 30 29 30 29 19 30 29 30 29 30 29 20 22 20 19 20 19 20 19 20 19 20 19 20 19 20 19 20 19 20 19 20 20 19 20 19 20 19 19 20 19 20 19 20 19 20 19 20 19 20 12 20 19 20 19 20 19 20 19 20 19 20 19 20 19 20 19 20 19 20 19 20 66 20 19 20 19 20 19 20 19 20 19 20 19 20 19 20 19 20 19 20 22 20 19 20 19 20 19 20 19 20 19 20 19 20 19 20 66 20 19 20 22 20 19 20 19 20 41 41 
51 12 29 30 29 30 29 30 29 27 27 30 29 22 29 30 29 30 29 30 29 30 29 30 29 30 29 66 66 30 29 30 29 30 29 30 29 30 29 30 29 30 29 30 29 22 29 30 29 30 29 30 29 30 29 30 29 30 29 30 22 30 29 30 29 30 29 66 29 30 29 20 19 20 19 20 19 20 66 19 20 19 20 19 29 66 19 20 19 20 19 30 12 30 29 30 29 30 29 30 29 30 30 58 58 58 58 29 30 29 30 29 30 29 30 29 30 29 29 30 29 30 29 30 29 30 29 30 29 30 22 30 29 30 29 30 29 30 66 30 29 30 29 30 29 30 29 30 29 30 29 30 29 30 29 30 29 30 29 30 29 30 29 30 31 31 31 31 29 30 29 30 12 30 29 30 29 30 29 30 29 30 29 30 29 30 29 30 29 30 29 30 12 30 29 30 29 30 1 51 
63 22 19 20 19 20 19 20 19 20 19 20 19 12 19 20 19 20 19 20 19 20 19 20 19 20 19 20 19 20 19 20 19 20 19 20 19 20 19 20 19 20 19 20 19 12 19 20 19 20 19 20 19 20 19 20 19 20 19 20 12 20 19 20 19 20 19 20 19 20 19 30 29 30 29 30 29 30 30 29 30 29 66 29 19 30 29 30 29 66 29 20 22 20 19 30 29 30 29 30 29 20 20 19 20 19 20 19 20 19 20 19 66 19 20 19 20 19 19 20 19 20 19 20 19 20 19 20 19 20 12 20 19 20 19 20 19 20 19 20 19 20 19 20 19 20 19 20 19 20 19 20 19 20 19 20 19 20 19 20 19 20 19 20 19 20 19 20 19 20 19 20 22 20 19 20 19 20 19 20 19 20 19 20 19 20 19 20 19 20 19 20 22 20 19 20 19 20 11 63 
73 12 29 30 29 30 29 30 29 30 29 30 29 22 29 30 29 30 29 30 29 30 29 30 29 30 29 30 29 30 29 30 29 30 29 30 29 30 29 30 29 30 29 30 29 22 29 30 29 30 11 31 31 31 31 11 29 30 29 30 22 30 29 30 29 20 19 20 19 20 29 20 19 20 19 20 19 20 20 19 20 19 20 19 29 20 19 20 19 20 19 30 12 30 29 20 19 20 19 20 19 30 30 29 30 29 30 29 30 29 30 29 30 29 30 29 66 29 29 30 29 30 29 30 29 30 29 30 29 30 22 30 29 30 29 30 29 30 29 30 66 30 29 30 29 30 29 30 29 30 29 30 29 30 29 30 29 30 29 30 31 31 31 31 29 30 29 30 29 30 29 30 12 30 29 30 35 30 29 30 29 30 29 30 29 30 29 30 29 30 29 30 12 30 29 30 29 30 21 73 
81 22 19 20 19 20 19 20 19 20 19 20 19 12 19 20 19 20 19 20 19 20 19 20 19 20 19 20 19 20 19 20 19 20 19 20 19 20 19 20 19 20 19 20 19 12 19 20 19 20 19 20 19 20 19 20 19 20 19 20 12 20 19 20 66 30 29 66 29 30 19 30 29 66 29 30 29 30 30 20 19 20 58 58 58 58 58 58 58 59 19 20 22 20 19 30 29 30 58 58 58 58 66 19 20 19 66 19 20 19 20 19 20 19 20 19 20 19 19 20 19 20 19 20 19 20 19 20 19 20 12 20 31 31 31 31 31 20 19 20 31 31 31 31 31 20 19 20 19 20 19 20 19 20 19 20 19 20 19 20 19 20 19 20 19 20 19 20 19 20 19 20 22 20 19 35 45 20 19 20 19 20 19 20 19 20 19 20 19 20 19 20 22 20 19 20 19 20 31 81 
91 12 29 30 29 30 29 30 29 30 29 30 29 22 29 30 29 30 29 30 29 30 29 30 29 30 29 30 29 27 29 30 29 27 11 31 31 31 31 31 31 30 29 30 29 22 29 30 29 30 29 30 29 30 29 30 29 30 29 30 22 35 26 37 38 55 37 38 37 38 29 20 19 20 19 20 19 20 20 30 29 30 29 30 29 30 29 30 29 30 29 30 12 30 29 66 19 20 19 20 19 30 30 29 30 29 30 29 30 29 66 29 29 30 29 30 29 30 29 30 35 26 35 26 37 38 39 30 29 30 22 30 29 30 29 30 29 30 29 30 29 30 29 30 29 30 29 30 29 66 29 30 29 30 29 30 29 31 31 31 29 30 29 30 29 66 29 30 29 30 29 30 12 30 35 45 55 30 29 30 29 30 29 30 29 30 29 30 29 30 29 30 12 30 29 30 29 30 41 91 
51 22 19 20 19 20 19 20 19 20 19 30 29 22 29 30 29 20 19 20 19 20 19 20 19 20 19 20 19 20 19 20 19 20 19 20 19 20 19 20 19 20 19 20 19 35 26 37 38 20 19 20 19 20 19 20 19 35 26 35 26 37 38 37 38 35 26 55 56 57 19 30 29 30 29 30 29 30 30 20 19 20 19 20 19 20 19 20 19 20 19 20 58 58 58 58 29 30 29 66 29 20 20 19 20 19 20 19 20 19 20 19 19 20 19 20 19 20 19 20 45 26 45 46 47 48 49 20 19 20 12 66 19 20 19 20 19 20 19 20 19 20 19 20 19 20 19 20 35 26 37 38 39 20 19 20 19 20 19 20 19 20 19 20 19 20 19 20 19 20 19 20 35 26 45 55 56 20 19 20 19 20 19 20 19 20 19 66 19 20 19 20 22 20 19 20 19 20 51 51 
63 12 29 30 29 30 29 30 29 30 29 30 29 22 29 30 29 30 29 30 29 30 35 26 37 38 39 30 29 30 29 30 29 30 29 30 29 30 29 30 29 30 29 35 26 45 46 47 48 37 38 30 66 30 29 35 26 45 46 45 46 47 48 26 37 38 37 55 56 57 29 35 26 37 38 35 26 37 38 30 29 30 29 30 29 30 29 30 29 30 29 30 12 30 29 20 19 20 19 20 19 30 29 30 29 30 29 30 29 30 29 30 29 30 29 30 35 26 37 38 35 46 55 56 35 26 37 38 39 30 22 30 29 30 29 30 29 30 29 30 29 30 29 30 29 30 29 30 45 46 47 48 49 30 29 30 29 30 29 30 29 30 29 30 29 30 29 30 29 30 29 35 26 37 55 56 57 30 29 30 29 30 29 30 29 30 29 30 29 30 29 30 12 30 29 30 29 30 63 63 
73 22 19 20 19 20 35 26 37 38 39 35 26 45 46 47 48 20 19 20 19 38 45 46 47 35 26 37 38 39 19 20 19 20 19 20 19 20 19 20 19 20 19 45 46 55 56 57 58 47 35 26 37 38 35 45 46 55 35 55 56 57 58 46 47 48 47 35 26 37 38 45 46 47 48 45 46 47 48 20 19 20 19 20 19 20 19 20 19 20 19 20 22 20 19 20 19 20 19 20 19 20 19 20 19 20 19 20 19 20 19 20 19 20 19 35 26 37 38 39 35 56 57 58 45 46 47 48 49 35 26 37 38 39 19 20 19 20 19 20 19 20 19 20 19 35 26 37 55 56 35 26 37 38 39 20 19 20 19 20 19 20 19 35 26 37 38 35 26 37 38 45 46 47 48 49 45 20 19 20 19 20 19 20 19 20 19 20 19 20 19 20 22 20 19 20 19 20 73 73 
81 12 29 30 29 30 45 46 47 48 49 45 46 55 56 57 58 59 45 46 47 48 55 56 57 45 46 47 48 35 26 37 38 39 29 30 29 30 29 30 29 35 26 55 56 57 58 55 56 57 45 46 47 48 45 55 56 57 45 46 47 48 55 56 57 58 57 45 46 47 48 55 56 57 58 55 56 57 58 26 37 38 29 30 29 35 26 37 38 39 57 58 59 38 39 35 57 58 59 39 35 26 57 58 59 39 39 30 29 30 29 35 26 37 38 45 46 47 48 49 45 46 47 48 55 56 57 58 59 45 46 47 48 35 26 37 38 39 29 30 29 30 29 30 29 45 46 47 48 49 45 46 47 48 49 30 29 30 29 30 29 30 29 45 46 47 48 45 46 47 48 55 56 57 58 59 55 30 29 30 29 30 29 30 29 30 29 30 29 30 29 30 12 30 29 30 29 30 81 81 
91 35 26 37 38 39 55 56 57 58 59 35 26 37 38 39 35 26 55 56 57 58 59 37 38 55 56 57 58 45 46 47 48 49 38 39 35 26 37 38 39 45 46 47 48 39 35 26 37 38 55 56 57 58 55 56 57 58 55 56 57 58 26 37 38 39 35 55 56 57 58 35 26 37 38 39 35 26 45 46 47 48 26 37 38 39 35 26 37 38 39 35 26 37 38 39 35 26 37 38 39 35 26 37 38 39 35 26 37 38 39 35 26 37 38 55 56 57 58 59 55 56 57 58 59 39 35 26 37 55 56 57 58 45 46 47 48 49 37 38 39 35 26 37 38 55 56 57 58 59 55 56 57 58 59 39 35 26 37 38 39 35 26 55 56 57 58 55 56 57 58 55 56 57 58 59 59 37 38 39 35 26 37 38 39 35 26 37 38 39 35 26 37 38 39 35 26 37 38 39

