2 3 2 3 4 5 6 7 8 9 10 35 36 37 1 2 3 4 5 6 7 8 9 10 2 3 
5 6 12 19 20 17 19 19 19 19 19 19 29 30 19 29 30 19 20 19 20 19 29 30 5 6 
11 83 12 19 20 19 20 29 17 29 19 29 19 20 29 30 19 29 30 29 17 29 19 20 39 26 
69 36 12 19 20 29 30 19 27 19 20 29 29 30 19 17 19 20 20 30 27 19 20 30 49 36 
79 46 22 29 30 17 20 29 30 29 17 30 19 29 29 27 20 19 17 19 19 29 19 20 37 38 
55 56 22 19 20 27 30 19 20 20 27 19 29 17 20 19 20 19 27 19 29 19 29 30 47 48 
68 69 22 19 20 20 20 29 30 30 17 29 19 27 19 29 30 29 19 29 19 29 30 17 59 37 
78 79 22 29 30 30 30 19 20 19 27 20 29 29 29 19 19 19 17 19 29 19 20 27 69 47 
39 51 22 19 20 19 20 19 20 29 30 30 29 19 19 29 29 29 27 29 29 19 20 20 79 51 
49 61 22 29 30 17 30 29 30 30 30 29 30 29 29 17 19 20 17 19 20 29 30 30 11 61 
59 71 22 19 20 27 20 20 19 20 20 17 20 19 20 27 20 30 27 19 20 17 20 40 35 71 
1 81 22 29 30 29 30 20 17 20 30 27 30 29 19 29 19 20 17 29 30 27 19 20 2 3 
11 91 22 19 20 19 19 20 27 19 19 20 19 19 19 20 29 30 20 19 19 20 19 20 35 91 
21 59 22 29 30 29 29 30 29 29 29 30 29 29 29 30 30 29 30 29 29 30 29 30 45 59 
4 5 6 35 36 37 51 31 41 7 8 46 47 55 56 57 58 4 5 6 35 36 37 51 31 41

