0 1 2 3 4 5 1 2 3 4 5 1 2 3 4 5 1 2 3 4 5 1 2 3 4 5 1 2 3 4 5 1 2 3 4 5 1 2 3 4 5 1 2 3 4 5 1 2 3 4 5 1 2 3 4 5 1 2 3 4 5 1 2 3 4 5 1 2 3 4 5 1 2 3 4 5 1 2 3 4 5 1 2 3 4 5 1 2 3 4 5 1 2 3 4 5 1 2 3 4 5 1 2 3 4 5 1 2 3 4 5 1 2 3 4 5 1 2 3 4 5 1 2 3 4 5 1 2 3 4 5 1 2 3 4 5 1 2 3 4 5 1 2 3 4 5 1 2 3 6 7 61 62 63 64 61 62 63 64 61 62 63 64 61 62 63 64 61 62 63 64 61 62 63 64 61 62 63 64 61 62 63 64 61 62 63 64 61 62 63 64 61 62 63 64 61 62 61 62 63 
0 11 12 13 14 15 11 12 13 14 15 11 12 13 13 13 13 13 13 14 15 11 12 13 14 15 11 12 13 13 13 13 13 13 14 15 11 12 13 14 15 11 12 13 13 13 13 13 13 14 15 11 12 13 14 15 11 12 13 14 15 11 12 13 13 13 13 13 13 14 15 11 12 13 14 15 11 12 13 13 13 13 13 13 14 15 11 12 13 14 15 11 12 13 13 13 13 13 13 14 15 11 12 13 14 15 11 12 13 14 15 11 12 13 13 13 13 13 13 14 15 11 12 13 14 15 11 12 13 13 13 13 13 13 14 15 11 12 13 14 15 11 12 13 13 13 13 13 13 16 17 71 72 73 74 71 72 73 74 71 72 73 74 71 72 73 74 71 72 73 74 71 72 73 74 71 72 73 74 71 72 73 74 71 72 73 74 71 72 73 74 71 72 73 74 71 72 71 72 73 
0 21 22 23 24 25 21 22 23 24 25 21 22 23 27 27 27 27 23 24 25 21 22 23 24 25 21 22 23 27 27 27 27 23 24 25 21 22 23 24 25 21 22 23 27 27 27 27 23 24 25 21 22 23 24 25 21 22 23 24 25 21 22 23 27 27 27 27 23 24 25 21 22 23 24 25 21 22 23 27 27 27 27 23 24 25 21 22 23 24 25 21 22 23 27 27 27 27 23 24 25 21 22 23 24 25 21 22 23 24 25 21 22 23 27 27 27 27 23 24 25 21 22 23 24 25 21 22 23 27 27 27 27 23 24 25 21 22 23 24 25 21 22 23 27 27 27 27 23 24 25 21 89 90 88 89 90 89 90 88 89 90 89 90 88 89 90 89 90 88 89 90 89 90 88 89 90 89 90 88 89 90 89 90 88 89 89 90 88 89 90 21 22 23 27 27 27 27 23 24 
0 21 22 23 24 25 21 22 23 24 25 21 22 23 27 27 27 27 23 24 25 21 22 23 24 25 21 22 23 27 27 27 27 23 24 25 21 22 23 24 25 21 22 23 27 27 27 27 23 24 25 21 22 23 24 25 21 22 23 24 25 21 22 23 27 27 27 27 23 24 25 21 22 23 24 25 21 22 23 27 27 27 27 23 24 25 21 22 23 24 25 21 22 23 27 27 27 27 23 24 25 21 22 23 24 25 21 22 23 24 25 21 22 23 27 27 27 27 23 24 25 21 22 23 24 25 21 22 23 27 27 27 27 23 24 25 21 22 23 24 25 21 22 23 27 27 27 27 23 24 25 21 99 100 98 99 100 99 100 98 99 100 99 100 98 99 100 99 100 98 99 100 99 100 98 99 100 99 100 98 99 100 99 100 98 99 89 90 88 89 90 21 22 23 27 27 27 27 23 24 
0 21 22 23 24 25 21 22 23 24 25 21 22 23 27 27 27 27 23 24 25 21 22 23 24 25 21 22 23 27 27 27 27 23 24 25 21 22 23 24 25 21 22 23 27 27 27 27 23 24 25 21 22 23 24 25 21 22 23 24 25 21 22 23 27 27 27 27 23 24 25 21 22 23 24 25 21 22 23 27 27 27 27 23 24 25 21 22 23 24 25 21 22 23 27 27 27 27 23 24 25 21 22 23 24 25 21 22 23 24 25 21 22 23 27 27 27 27 23 24 25 21 22 23 24 25 21 22 23 27 27 27 27 23 24 25 21 22 23 24 25 21 22 43 44 43 27 27 23 24 25 21 89 90 88 89 90 89 90 88 89 90 89 90 88 89 90 89 90 88 89 90 89 90 88 89 90 89 90 88 89 90 89 82 82 89 99 100 98 99 100 21 22 23 27 27 27 27 23 24 
0 21 22 23 24 25 21 22 23 24 25 21 22 23 27 27 27 27 23 24 25 21 22 23 24 25 21 22 23 27 27 27 27 23 24 25 21 22 23 43 44 45 41 42 43 27 27 27 23 24 25 21 22 23 24 25 21 22 23 24 25 21 22 23 27 27 27 27 23 24 25 21 22 23 24 25 21 22 23 27 27 27 27 23 24 25 21 22 23 24 25 21 22 23 27 27 27 27 23 24 25 21 22 23 24 25 21 22 23 43 44 43 22 23 27 27 27 27 23 24 25 21 22 23 24 25 21 22 23 27 27 27 27 23 24 25 21 22 23 24 25 21 22 23 27 27 27 27 23 24 25 21 99 100 98 99 100 99 100 98 99 100 99 100 98 99 100 99 100 98 99 100 99 100 98 99 100 99 100 98 99 100 81 92 82 99 89 90 88 89 90 21 22 23 27 27 27 27 23 24 
0 21 22 23 24 25 21 22 23 24 25 21 22 23 27 27 27 27 23 24 25 21 22 23 24 25 21 22 23 27 27 27 27 23 24 25 21 22 23 24 25 21 22 23 27 27 27 27 23 24 25 21 22 23 24 25 21 22 43 44 43 21 22 23 27 27 27 27 23 24 25 21 22 23 24 25 21 22 23 27 27 27 27 23 24 25 21 22 23 24 25 21 22 23 27 27 27 27 23 24 25 21 22 23 24 25 43 44 43 24 25 21 22 23 27 27 27 27 23 24 25 21 22 23 24 25 21 22 23 27 27 27 27 23 24 25 21 22 23 24 25 21 22 23 27 27 27 27 23 24 25 21 89 90 88 89 90 89 90 88 89 90 89 90 88 89 90 89 90 88 89 90 89 90 88 89 90 89 90 88 89 81 91 92 92 89 99 100 98 99 100 21 22 23 27 27 27 27 23 24 
0 21 22 23 24 43 44 45 41 42 43 21 22 23 27 27 27 27 23 24 25 21 22 23 24 25 21 22 23 27 27 27 27 23 24 25 21 22 23 24 25 21 22 23 27 27 27 27 23 43 44 43 22 23 24 25 21 22 23 24 25 21 22 23 27 27 27 27 23 24 25 21 22 23 24 25 21 22 23 27 27 27 27 23 24 25 21 22 23 24 25 21 22 23 27 27 27 43 44 43 43 44 43 43 44 43 21 22 23 24 25 21 22 23 27 27 27 27 23 43 44 43 43 44 43 43 44 43 43 44 43 43 44 43 43 44 43 22 23 24 25 21 22 23 27 27 27 27 23 24 25 21 99 100 98 99 100 99 100 98 99 100 99 100 98 99 100 99 100 98 99 100 99 100 98 99 100 99 100 98 81 91 91 92 92 99 89 90 88 89 90 21 22 23 27 27 27 27 23 24 
0 21 22 23 24 25 21 22 23 24 25 21 22 23 27 27 27 27 43 44 45 41 42 43 43 44 45 41 42 43 43 44 45 41 42 43 21 22 23 24 25 21 22 23 27 27 27 27 23 24 25 21 22 23 24 25 21 22 23 24 25 21 22 23 27 27 27 27 23 24 25 21 22 23 24 25 21 22 23 27 27 27 27 23 24 25 21 22 23 24 25 21 22 23 43 44 43 27 23 24 25 21 22 23 24 25 21 22 23 24 25 21 22 23 27 27 27 27 23 24 25 21 22 23 24 25 21 22 23 27 27 27 27 23 24 25 21 22 23 24 25 21 22 23 27 27 27 27 23 24 25 21 89 90 88 89 90 89 90 88 89 90 89 90 88 89 90 89 90 88 89 90 89 90 88 89 90 89 81 82 91 92 91 92 92 89 99 100 98 99 100 21 22 23 27 27 27 27 23 24 
0 21 22 23 24 25 21 22 23 24 25 21 22 23 27 27 27 27 23 24 25 21 22 23 24 25 21 22 23 27 27 27 27 23 24 25 21 22 23 24 25 21 22 23 27 27 27 27 23 24 25 21 22 23 24 25 21 22 23 24 25 21 22 23 27 27 27 43 44 43 25 21 22 23 24 25 21 22 23 27 27 27 27 23 24 25 21 22 23 24 25 43 44 43 27 27 27 27 23 24 25 21 22 23 24 25 21 22 23 24 25 21 22 23 27 27 27 27 23 24 25 21 22 23 24 25 21 22 23 27 27 27 27 23 24 25 21 22 23 24 25 21 22 23 27 27 27 27 23 24 25 21 99 100 98 99 100 99 100 98 99 100 99 100 98 99 100 99 100 98 99 100 99 100 98 99 100 99 91 92 91 92 91 92 92 99 89 90 88 89 90 21 22 23 27 27 27 27 23 24 
0 21 22 23 24 25 21 22 23 24 25 21 22 23 27 27 27 27 23 24 25 21 22 23 24 25 21 22 23 27 27 27 27 23 24 25 21 22 23 43 44 45 41 42 43 27 27 27 23 24 25 21 22 23 43 44 43 22 23 24 25 21 22 23 27 27 27 27 23 24 25 21 22 23 24 25 21 22 23 27 27 27 27 23 24 43 44 43 43 44 43 21 22 23 27 27 27 27 23 24 25 21 22 23 24 25 21 22 23 24 25 21 22 43 44 43 27 27 23 24 25 21 22 23 24 25 21 22 23 27 27 27 27 23 24 25 21 22 23 24 25 21 22 43 44 43 27 27 23 24 25 43 44 43 88 89 90 89 90 88 89 90 89 90 88 89 90 89 90 88 89 90 89 90 88 89 81 82 91 92 91 92 91 92 92 89 99 100 98 99 100 21 22 23 27 27 27 27 23 24 
0 21 22 23 24 25 21 22 23 24 25 21 43 44 45 41 42 43 23 24 25 21 22 23 24 25 21 22 23 27 27 27 27 23 24 25 21 22 23 24 25 21 22 23 27 27 27 27 23 24 25 21 22 23 24 25 21 22 23 24 25 21 22 23 27 27 27 27 23 24 25 21 22 23 24 25 21 22 23 27 27 27 43 44 43 25 21 22 23 24 25 21 22 23 27 27 27 27 23 24 25 21 22 23 24 25 21 22 23 24 25 21 22 23 27 27 27 27 23 24 25 21 22 23 24 25 21 22 23 27 27 27 27 23 24 25 21 22 23 24 25 21 22 23 27 27 27 27 23 24 25 21 99 100 98 99 100 99 100 98 99 100 99 100 98 99 100 99 100 98 99 100 99 100 98 99 91 92 91 92 91 92 91 92 92 99 89 90 88 89 90 21 22 23 27 27 27 27 23 24 
0 21 22 23 24 25 21 22 23 24 25 21 22 23 27 27 27 27 23 24 25 21 22 23 24 25 21 22 23 27 27 27 27 23 24 25 21 22 23 24 25 21 22 23 27 27 27 27 23 24 25 21 22 23 24 25 21 22 23 24 25 21 22 23 27 27 27 27 23 24 25 21 22 23 24 25 21 22 23 43 44 43 27 23 24 25 21 22 23 24 25 21 22 23 27 27 27 27 23 24 25 21 22 23 24 25 21 22 23 24 25 21 22 23 27 27 27 27 23 24 25 21 22 23 24 25 21 22 23 27 27 27 27 23 24 25 21 22 23 24 25 21 22 23 27 27 27 27 23 24 25 21 98 99 100 98 99 100 99 100 81 82 81 82 81 82 81 82 81 82 98 99 100 99 100 81 91 92 91 92 91 92 91 92 92 98 99 100 98 99 100 21 22 23 27 27 27 27 23 24 
0 31 32 33 34 35 31 32 33 34 35 31 32 33 34 34 34 32 33 34 35 31 32 33 34 35 31 32 33 34 34 34 32 33 34 35 31 32 33 34 35 31 32 33 34 34 34 32 33 34 35 31 32 33 34 35 31 32 33 34 35 31 32 33 34 34 34 32 33 34 35 31 32 33 34 35 43 44 43 34 34 34 32 33 34 35 31 32 33 34 35 31 32 33 34 34 34 32 33 34 35 31 32 33 34 35 31 32 33 34 35 31 32 33 34 34 34 32 33 34 35 31 32 33 34 35 31 32 33 34 34 34 32 33 34 35 31 32 33 34 35 31 32 33 34 34 34 32 33 34 36 37 81 82 83 84 81 82 83 84 91 92 91 92 91 92 91 92 91 92 83 84 81 82 83 91 92 91 92 91 92 91 92 91 92 82 83 84 81 82 83 84 81 82 83 84 81 82 83 84 
0 41 42 43 44 45 41 42 43 44 45 41 42 43 44 45 41 42 43 44 45 41 42 43 44 45 41 42 43 44 45 41 42 43 44 45 41 42 43 44 45 41 42 43 44 45 41 42 43 44 45 41 42 43 44 45 41 42 43 44 45 41 42 43 44 45 41 42 43 44 45 41 42 43 44 45 41 42 43 44 45 41 42 43 44 45 41 42 43 44 45 41 42 43 44 45 41 42 43 44 45 41 42 43 44 45 41 42 43 44 45 41 42 43 44 45 41 42 43 44 45 41 42 43 44 45 41 42 43 44 45 41 42 43 44 45 41 42 43 44 45 41 42 43 44 45 41 42 43 44 46 47 91 92 93 94 91 92 93 94 91 92 93 94 91 92 93 94 91 92 93 94 91 92 93 94 91 92 93 94 91 92 93 94 91 92 93 94 91 92 93 94 91 92 93 94 91 92 93 94

